6 5
######
#1   #
#    #
#   2#
######
